WWWWWWWWWWWWWWWWWWWWWWWWWWWWWWWWWWWWWWWWWWWWWWWWWWWWWWWWWWWWWWWWW
W                                                               W
W                                                               W
W                                                               W
W                                                               W
W                                                               W
W                                                               W
W      WWWWWWWWWWWWWWWWWWWWWWWWWWWWWWWWWWWWWWWWWWWWWWWWW        W
W                                                               W
W                                                               W
W                                                               W
W                                                               W
W                                                               W
W                                                               W
W                       WWWWWWWWWWWWWWW                         W
W                                                               W
W                                                               W
W                                                               W
W                                                               W
W                                                               W
W                               P                               W
W                                                               W
W                                                               W
W                                                               W
W                                                               W
W                                                               W
W                                                               W
W       WWWWWWWWWWWWWWWWWWWWWWWWWWWWWWWWWWWWWWWWWWWWWWWWW       W
W                                                               W
W                                                               W
W                                                               W
W                                                               W
W                                                               W
W                                                               W
W                                                               W
WWWWWWWWWWWWWWWWWWWWWWWWWWWWWWWWWWWWWWWWWWWWWWWWWWWWWWWWWWWWWWWWW
