WWWWWWWWWWWWWWWWWWWWWWWWWWWWWWWWWWWWWWWWWWWWWWWWWWWWWWWWWWWWWWWWW
W        W                W               W             W       W
W        W                W               W             W       W
W        W                W               W             W       W
W        W                W               W             W       W
W        W                W               W             W       W
W        W                W               W             W       W
W        W                W               W             W       W
W                                                               W
W                                                               W
W                                                               W
W                                                               W
W                                                               W
W                                                               W
W                                                               W
W       WWWWWWWWWWWWWWWWWWWWWWWWWWWWWWWWWWWWWWWWWWWWWWWWWW      W
W                                                               W
W                                                               W
W                                                               W
W                                  P                            W
W                                                               W
W                                                               W
W                                                               W
W          W                 W              W                   W
W                                                               W
W                                                               W
W                                                               W
W                                                               W
W                                                               W
W                  W                W                           W
W       W                                         W             W
W                                                               W
W                                                               W
W                                                               W
W                                                               W
WWWWWWWWWWWWWWWWWWWWWWWWWWWWWWWWWWWWWWWWWWWWWWWWWWWWWWWWWWWWWWWWW
