WWWWWWWWWWWWWWWWWWWWWWWWWWWWWWWWWWWWWWWWWWWWWWWWWWWWWWWWWWWWWWWWW
W                                                               W
W                                                               W
W                                                               W
W                                                               W
W                                                               W
W                                                               W
WWWWWWWWWWWWWWWWWWWWWWWWWWWWWWWW                                W
W                                                               W
W                                               WWWWWWWWWWWWWWWWW
W                                                               W
W                                                               W
W                                                               W
W                           P                                   W
W             W                                                 W
W             W                                                 W
W             W                                                 W
W             W                                                 W
W             W                                                 W
W             W                                                 W
W             W                        WWWWW                    W
W             W                        W                        W
W             W                        W                        W
W             W                                                 W
W             W                                                 W
W             W                                                 W
W             W                                                 W
W             W                                                 W
W             W                                                 W
W             W                                                 W
W             W                                                 W
W             W                                                 W
W             W                                                 W
W             W                                                 W
W             W                                                 W
WWWWWWWWWWWWWWWWWWWWWWWWWWWWWWWWWWWWWWWWWWWWWWWWWWWWWWWWWWWWWWWWW
