WWWWWWWWWWWWWWWWWWWWWWWWWWWWWWWWWWWWWWWWWWWWWWWWWWWWWWWWWWWWWWWWW
W                                                               W
W                                                               W
W                                                               W
W                                                               W
W                                                               W
W                                                               W
W             WWWWWWWWWWW                                       W
W             W                                                 W
W             W                                                 W
W             W                                                 W
W             WWWWWWWWWWW                                       W
W                                            WWWWWWWWWWW        W
W                                                               W
W                                                               W
W                             P                                 W
W                                                               W
W                                                               W
W                                                               W
W                                            WWWWWWWWWWW        W
W                       WWWWWWWWWWW                             W
W                                 W                             W
W                                 W                             W
W                                 W                             W
W                                 W                             W
W                                 W                             W
W                                 W                             W
W                       WWWWWWWWWWW                             W
W                                                               W
W                                                               W
W                                                               W
W                                                               W
W                                                               W
W                                                               W
W                                                               W
WWWWWWWWWWWWWWWWWWWWWWWWWWWWWWWWWWWWWWWWWWWWWWWWWWWWWWWWWWWWWWWWW
