WWWWWWWWWWWWWWWWWWWWWWWWWWWWWWWWWWWWWWWWWWWWWWWWWWWWWWWWWWWWWWWWW
W                   W                                           W
W                   W                                           W
W                   W                                           W
W                   W                                           W
W                   W                                           W
W                                                               W
W                                                               W
W                                                               W
W                                                               W
W                                                               W
W                                                               W
W                                 P                             W
WWWWWWWWWWWWWWW                                                 W
W                                                               W
W                                                               W
W                                                               W
W                      WWWWWWWWWWWWWWWWWWW                      W
W                                                               W
W                                                               W
W                                                               W
W                                                               W
W                                                               W
W                                                               W
W                                          WWWWWWWWWWWWWWWWWWWWWW
W                                                               W
W             W                                                 W
W             W                                                 W
W             W                                                 W
W             W                                                 W
W             W                                                 W
W             W                                                 W
W             W                                                 W
W             W                                                 W
W             W                                                 W
WWWWWWWWWWWWWWWWWWWWWWWWWWWWWWWWWWWWWWWWWWWWWWWWWWWWWWWWWWWWWWWWW
