WWWWWWWWWWWWWWWWWWWWWWWWWWWWWWWWWWWWWWWWWWWWWWWWWWWWWWWWWWWWWWWWW
W                                                               W
W                                                               W
W                                                               W
W         WWWWWWW                                               W
W                                                               W
W                                                               W
W                                                               W
W                              WWWWWWWWWWWWWWWWWWWW             W
W                                                               W
W                                                               W
W                                                               W
W                W                                              W
W                W                                              W
W                W                                              W
W          WWWWWWWWWWWWWWWWWWWWWWWWWW                           W
W                                                               W
W                                                               W
W                                                               W
W                                                               W
W                              P                W               W
W                                                               W
W                                                               W
W                                                               W
W             W                                                 W
W             W                                                 W
W             W                                                 W
W             W                                                 W
W             W                          WWWWWWWWWWWWWWWWWWWWWWWW
W             W                                                 W
W                                                               W
W                                                               W
W                                                               W
W                                                               W
W                                                               W
WWWWWWWWWWWWWWWWWWWWWWWWWWWWWWWWWWWWWWWWWWWWWWWWWWWWWWWWWWWWWWWWW
