WWWWWWWWWWWWWWWWWWWWWWWWWWWWWWWWWWWWWWWWWWWWWWWWWWWWWWWWWWWWWWWWW
W                                                               W
W                                                               W
W                                                               W
W                                                               W
W                                                               W
W                                                               W
WWWWWWWWWWWWWWWWWWWWWWWW                                        W
W                                                               W
W                                                               W
W                                                               W
W                                         WWWWWWWWWWWWWWWWWWWWWWW
W                                                               W
W                                                               W
W                                                               W
WWWWWWWWWWWWWWWWWWWWWW                                          W
W                                                               W
W                               P                               W
W                                                               W
W                                                               W
W                                                               W
W                                                               W
W                                                               W
W                                        WWWWWWWWWWWWWWWWWWWWWWWW
W                                                               W
W                                                               W
W                                                               W
W                                                               W
WWWWWWWWWWWWWWWWWWWWWWW                                         W
W                                                               W
W                                                               W
W                                       W                       W
W                                       W                       W
W                                       W                       W
W                                       W                       W
WWWWWWWWWWWWWWWWWWWWWWWWWWWWWWWWWWWWWWWWWWWWWWWWWWWWWWWWWWWWWWWWW
