WWWWWWWWWWWWWWWWWWWWWWWWWWWWWWWWWWWWWWWWWWWWWWWWWWWWWWWWWWWWWWWWW
W                                                               W
W                                                               W
W                                                               W
W                                    WWWWWWWWW                  W
W                                    W       W                  W
W       WWWWWWWWWWWW                 W       W                  W
W       W          W                 W       W                  W
W       W          W                 W       W                  W
W       W          W                 W       W                  W
W       W          W                 W       W                  W
W       W          W                 W       W                  W
W       W          W                                            W
W       W          W                                            W
W                                                               W
W                                        W                      W
W                              P                                W
W                                                               W
W                   W                   W         W             W
W                                       W         W             W
W                                       W         W             W
W                                       W         W             W
W         WWWWWWWW                      W         W             W
W         W      W                      W         W             W
W         W      W                      W         W             W
W         W      W                      WWWWWWWWWWW             W
W         W      W                                              W
W                                                               W
W                                                               W
W                          W                                    W
W                          W                      W             W
W                          W                                    W
W                          W                                    W
W                          W                                    W
W                          W                                    W
WWWWWWWWWWWWWWWWWWWWWWWWWWWWWWWWWWWWWWWWWWWWWWWWWWWWWWWWWWWWWWWWW
