WWWWWWWWWWWWWWWWWWWWWWWWWWWWWWWWWWWWWWWWWWWWWWWWWWWWWWWWWWWWWWWWW
W                 WW                                            W
W                                                               W
W                                                               W
W                         WW                                    W
W                                                               W
W                                                               W
W                                       WW                      W
W                                                               W
W     WW                                                        W
W                                                          WW   W
W                       WW                                      W
W                                                               W
W                                                               W
W        WW                                         WW          W
W                                                               W
W                                                               W
W                                  P                            W
W                                                               W
W                                                               W
W                                                               W
W              WW                                               W
W                                                               W
W                                                               W
W                               WW                              W
W                                                               W
W                                                               W
W                                                               W
W           WW                               WW                 W
W                                                               W
W                                                               W
W                                                               W
W                                                               W
W                                                               W
W                                                               W
WWWWWWWWWWWWWWWWWWWWWWWWWWWWWWWWWWWWWWWWWWWWWWWWWWWWWWWWWWWWWWWWW
